

O2: 500	Temp: 135


Wgri 8	
air:	220	180	140	100	80	60	40	20	
rpm:	5000	3589	2589	1863	1341	965	695	500

Winj 8
	1931	1203	766	596	564	561	560	589
	2476	1596	944	615	587	587	588	901
	2464	2006	1223	749	618	635	645	624
	2471	2338	1632	949	749	635	676	710
	2472	2170	1898	1229	940	774	757	827
	2471	2171	1922	1619	1176	945	775	776
	2473	2161	1900	1744	1484	1166	988	925
	2473	2160	1899	1789	1537	1301	1185	1129



# acceleration enrichment stabilize rate
# cold engine threshold 
# cranking duration nominal 
# choke scale (extra injector duration vs coolant temperature) 

Wacc 20
Wcld 140
Wcra 1350
Wcho 4
temp	160	100	50	10
choke	20	200	700	1024


Wtem 11
563	454	356	278	208	157	116	88	66	52	41
32	50	68	86	104	122	140	158	176	194	212