


# acceleration enrichment stabilize rate
# cold engine threshold 
# cranking duration nominal 
# choke scale (extra injector duration vs coolant temperature) 

Wglo -171
Wcrp 1500
Wirp 1400
Wath 90
Wcld 175
Wcra 1640

Wcho 5
temp	180	120	60	10	-20
choke	0	170	650	850	1000

Wtem 12
563	454	356	278	208	157	116	88	66	52	41	32
32	50	68	86	104	122	140	158	176	194	212	230

Wisc 2
500	1300
1000	600

Wgri 8	
air:	220	180	140	100	80	60	40	20	
rpm:	5000	3589	2589	1863	1341	965	695	500

Winj 8
	1931	1203	766	596	564	561	560	589
	2476	1596	944	615	587	587	588	901
	2464	2006	1223	749	618	635	645	624
	2471	2338	1632	949	749	635	676	710
	2472	2170	1898	1229	940	774	757	827
	2471	2171	1922	1619	1176	945	775	776
	2473	2161	1900	1744	1484	1166	988	925
	2473	2160	1899	1789	1537	1301	1185	1129

Wloc 8
 	10	40	11	0	0	-4	-1	0	
 	82	-53	-2	-247	112	-196	-197	-18	
 	63	120	76	-159	77	-73	-116	-24	
 	0	32	-89	-244	94	-119	-181	-5	
 	0	16	275	-79	-177	258	626	-5	
 	0	0	82	26	-28	294	353	0	
 	0	0	-1	-2	-4	105	204	1	
 	0	0	0	0	0	10	49	1	


## O2 lower thresh	/  o2 upper thresh	/  O2 warming time 
## local sum limit	/  tweak size		/  engine warming time

Wout 570
Wolt 350
Wtsz 4
Wlsl 300

Wowi 20
Wewi 30
Weri 30
Wiaf 100

Sbos
S
