>>rglo
global_offset: -171
>>para
coasting_rpm: 1500
idling_rpm: 1400
air_thresh: 90
cold_thresh: 175
cranking_dur: 1640

>>rinj
air_gridline:
	220	180	140	100	80	60	40	20	
rpm_gridline:
	5000	3589	2589	1863	1341	965	695	500	
map:
 	1931	1203	766	596	564	561	560	589	
 	2476	1596	944	615	587	587	588	901	
 	2464	2006	1223	749	618	635	645	624	
 	2471	2338	1632	949	749	635	676	710	
 	2472	2170	1898	1229	940	774	757	827	
 	2471	2171	1922	1619	1176	945	775	776	
 	2473	2161	1900	1744	1484	1166	988	925	
 	2473	2160	1899	1789	1537	1301	1185	1129	

rloc>>
air_gridline:
	220	180	140	100	80	60	40	20	
rpm_gridline:
	5000	3589	2589	1863	1341	965	695	500	
map:
 	10	40	11	0	0	-4	-1	0	
 	82	-53	-2	-247	112	-196	-197	-18	
 	63	120	76	-159	77	-73	-116	-24	
 	0	32	-89	-244	94	-119	-181	-5	
 	0	16	275	-79	-177	258	626	-5	
 	0	0	82	26	-28	294	353	0	
 	0	0	-1	-2	-4	105	204	1	
 	0	0	0	0	0	10	49	1	

>>rbos
o2_upper_thr: 570   o2_lower_thr: 390   step: 1   local_sum_limit: 300   rpm_hyst: 60   idle_backstep: 45
time thresholds->  warming_o2: 20   warm: 30   running: 30   idle_adjust_freq: 100

>>rcho
x: 	180	120	60	10	-20	
y: 	0	160	700	900	1000	

>>rtem
x: 	563	454	356	278	208	157	116	88	66	52	41	32	
y: 	32	50	68	86	104	122	140	158	176	194	212	230	

>>rgri
x: 	220	180	140	100	80	60	40	20	
y: 	5000	3589	2589	1863	1341	965	695	500	